################################
#..............................#
#..............................#
#........#.............#.......#
#..............................#
#....................#.........#
#....................#.........#
#....................#.........#
#....................#.........#
#.....##.....###...............#
#..............................#
#..............................#
#..............................#
#..............................#
#...........####...............#
#..............................#
#.......#......................#
#.......#......................#
#.......#......................#
#..............................#
#.........#..........#.........#
#..............................#
#..............................#
################################
