###################...##########
#....###.......................#
#.............#..#.............#
#........######..#####.........#
#....................#.........#
#........##########..#.........#
#.................#..#.........#
#.................#..#.........#
#.....##....#######..###########
#...........#..................#
#...........#..................#
#...........#..................#
#..............................#
#...........####...............#
#....................#...#.....#
#.......#............#...#.....#
#.......#............#...#.....#
#.......#............#...#.....#
#........................#.....#
#.........#......#####...#.....#
#........................###...#
#..............................#
#..............................#
###################...##########
